1111111111111111111
10010000000C000C001
10000111110000000C1
1P0011E000000C00001
1000000001110001001
11111111C1110000001
1C00000001100000001
1111111111111111111
