111111111111111111111111
100P00C00010000000000011
111111101110101111110001
1000C0000010101111111101
1C11111111101011000C0001
10000000C000101001111111
111111111111101011111101
111C000000000010000C0001
111111101111111111111101
111111100000C0010C000001
111111111111110101111111
1C0000C00000000100000001
111101111111111111111101
100000000C00000000011101
10C0000000000000E00011C1
111111111111111111111111
